N:レールタイプ
T:100
S:15,17
D:0,0,0,0,0,0,0,0,0,0,0,0,0,0,0
D:0,0,3,3,2,0,0,3,3,0,0,0,0,0,0
D:0,0,3,3,0,0,3,3,0,0,3,0,2,0,0
D:0,0,0,0,0,0,3,3,0,0,3,3,0,0,0
D:0,0,3,3,3,3,3,0,0,2,3,3,0,0,0
D:0,3,0,0,0,0,0,0,0,0,0,0,0,0,0
D:0,3,0,0,0,0,0,0,0,0,0,0,0,0,0
D:0,3,0,0,0,0,0,0,0,0,0,0,0,3,0
D:0,3,3,3,3,3,0,3,0,3,3,3,3,3,0
D:0,3,0,0,0,0,0,0,0,0,0,0,0,3,0
D:0,0,0,0,0,0,0,0,0,0,0,0,0,3,0
D:0,0,0,0,0,0,0,0,0,0,0,0,0,3,0
D:0,0,0,3,3,2,0,0,3,3,3,3,3,0,0
D:0,0,0,3,3,0,0,3,3,0,0,0,0,0,0
D:0,0,2,0,3,0,0,3,3,0,0,3,3,0,0
D:0,0,0,0,0,0,3,3,0,0,2,3,3,0,0
D:0,0,0,0,0,0,0,0,0,0,0,0,0,0,0
C:1,4
H:13,12
